11111
100E1
1C001
10C01
100C1
1P001
11111
