1111111111
100C000001
1111111101
1P0000C001
1000C000E1
1111111111