111111111111
100000E00001
100000000001
1000C0000001
100000C00001
10C000000001
10000P000001
111111111111