11111111111
100000E0001
10000000001
1000C000001
100000C0001
10C00000001
10000P00001
11111111111
